0 0 0 0 0 0
0 4 2 2 2 0
0 0 0 0 2 0
6 2 0 2 3 5
0 2 3 4 2 0
0 1 0 0 0 0 ]
